









             1111111111111111111111111111                    
          11122222222222222222222222222221111                
1111111111222222222222222222222222222222222221111111111111111
2222222222222333333333333333333333333333332222222222222222222
3333333333333333333333333333333333333333333333333333333333333
3333333333333333333333333333333333333333333333333333333333333
3333333333333333333333333333333333333333333333333333333333333
3333333333333333333333333333333333333333333333333333333333333
3333333333333333333333333333333333333333333333333333333333333
3333333333333333333333333333333333333333333333333333333333333
3333333333333333333333333333333333333333333333333333333333333
3333333333333333333333333333333333333333333333333333333333333
3333333333333333333333333333333333333333333333333333333333333
3333333333333333333333333333333333333333333333333333333333333
3333333333333333333333333333333333333333333333333333333333333
3333333333333333333333333333333333333333333333333333333333333
3333333333333333333333333333333333333333333333333333333333333
3333333333333333333333333333333333333333333333333333333333333
3333333333333333333333333333333333333333333333333333333333333
3333333333333333333333333333333333333333333333333333333333333