0000000000000000000000000011100000000000000000000000000000000
0000000000000001000000000100001000000000000000000000000000000
0000000000000010000000001000000100000000000000000000000000000
0000000000000100000000010000000010000000000000000000000000000
0000000000001000000000100000000001000000000000000000000000000
0000000000010000000001000000000000100000000000000000000000000
0000000000100000000010000000000000010000000000000000000000000
0000000001000000000100000000000000001000000000000000000000000
0000000010000000001000000000000000000100000000000000000000000
0000000100000000010000000000000000000010000000000000000000000
00000010000000001000000000000000000000010000000000000000000000
0000010000000001000000000000000000000000100000000000000000000
0000100000000111111111111111111111111111100000000000000000000
0001000000111222222222222222222222222222211110000000000000000
1111111111222222222222222222222222222222222221111111111111111
2222222222222333333333333333333333333333332222222222222222222
3333333333333333333333333333333333333333333333333333333333333
3333333333333333333333333333333333333333333333333333333333333
3333333333333333333333333333333333333333333333333333333333333
3333333333333333333333333333333333333333333333333333333333333
3333333333333333333333333333333333333333333333333333333333333
3333333333333333333333333333333333333333333333333333333333333
3333333333333333333333333333333333333333333333333333333333333
3333333333333333333333333333333333333333333333333333333333333
3333333333333333333333333333333333333333333333333333333333333
3333333333333333333333333333333333333333333333333333333333333
3333333333333333333333333333333333333333333333333333333333333
3333333333333333333333333333333333333333333333333333333333333
3333333333333333333333333333333333333333333333333333333333333
3333333333333333333333333333333333333333333333333333333333333
3333333333333333333333333333333333333333333333333333333333333
3333333333333333333333333333333333333333333333333333333333333
