0000000000000000000000000000000000000000000000000000000000000
0000000000000000000000000000000000000000000000000000000000000
0000000000000000000000000000000000000000000000000000000000000
0000000000000000000000000000000000000000000000000000000000000
0000000000000000000000000000000000000000000000000000000000000
0000000000000000000000000000000000000000000000000000000000000
0000000000000000000000000000000000000000000000000000000000000
0000000000000000000000000000000000000000000000000000000000000
0000000000000000000000000000000000000000000000000000000000000
0000000000000000000000000000000000000000000000000000000000000
0000000000000000000000000000000000000000000000000000000000000
0000000000000000000000000000000000000000000000000000000000000
0000000000000111111111111111111111111111100000000000000000000
0000000000111222222222222222222222222222211110000000000000000
1111111111222222222222222222222222222222222221111111111111111
2222222222222333333333333333333333333333332222222222222222222
3333333333333333333333333333333333333333333333333333333333333
3333333333333333333333333333333333333333333333333333333333333
3333333333333333333333333333333333333333333333333333333333333
3333333333333333333333333333333333333333333333333333333333333
3333333333333333333333333333333333333333333333333333333333333
3333333333333333333333333333333333333333333333333333333333333
3333333333333333333333333333333333333333333333333333333333333
3333333333333333333333333333333333333333333333333333333333333
3333333333333333333333333333333333333333333333333333333333333
3333333333333333333333333333333333333333333333333333333333333
3333333333333333333333333333333333333333333333333333333333333
3333333333333333333333333333333333333333333333333333333333333
3333333333333333333333333333333333333333333333333333333333333
3333333333333333333333333333333333333333333333333333333333333
3333333333333333333333333333333333333333333333333333333333333
3333333333333333333333333333333333333333333333333333333333333