000000000000000000000000000000000000000000
000000000000000000000000000000000000000000
000000000000000000000000000000000000000000
000000001111111111000000000011111111110000
000000001111111111000000000011111111110000
000000001111111111000000000011111111110000
000000001111111111000111000011111111110000
000000001111111111000010000011111111110000
000000000000000000000010000000000000000000
000000000000000000000000000000000000000000
000000000000000000000000000000000000000000
000000111111111111111111111111111110000000